0 0 0 0 0 0 P 0 0
0 G G G G G S G 0
0 G G G G G S G 0
0 G G G G G S G 0
0 G G G G G S G 0
P S S S S S S S P
0 G G G S G G G 0
0 G G G S G G G 0
0 0 0 0 P 0 0 0 0
