0 0 0 0 P 0 0 P 0 0 0 0 0 P 0 0 0
0 G G G S G G S G G G G G S G G 0
P S S S S S S S G G P G G S G G 0
0 G G G G G G S G G S G G S G G 0
0 G G G G G G S G G S G G S G G 0
P S S S T S S S S T S S S T S S P
0 G G G S G G G G S G G G S G G 0
0 G G G S G G G G S G G G S G G 0
0 G G G S G G G G S G G G S G G 0
0 G G G S S S P G S G G G S G G 0
0 G G G S G G G G S G G G S S S P
0 G G G S G G G G S G G G S G G 0
P S S S S G G G G S G G G S G G 0
0 G G G S G G G G S G G G S G G 0
0 G G G S G G G G S G G G S S S P
P S S S S G G G G S G G G S G G 0
0 0 0 0 P 0 0 0 0 P 0 0 0 P 0 0 0
